111111111111111111111111111111111111111111111111111111111111111111
100000000000001000000001C00C00000CC00000000CC00000000CC000000000C1
10P0C0C0C0C0C0C000000001C00C11000CC00011000CC00011000CC000110000C1
111111111111111C00000001C00100100CC00100100CC00100100CC011111000C1
1000C0C0C0C0C0C0C0000001C01000010CC01000010CC01000010CC010000100C1
100000000000001000000001C10000001CC10000001CC10000001CC100000010C1
1111111111111110C00000010000000001100000000110000000011000000001C1
10000000000000000C0C0C0CCCCCCCCCCCCCCCCCCCCCCCCCCCCCCCCCCCCCCCCCC1
1000000010000000C00000000000000000000000000000000000000000000000C1
10000011111000000000000000000000000000000000C0C0C0C0C0C0C0C0C0C0C1
1000000010000000C0011111111111111111111111C000100C01111111111111C1
10000000000000000001010101010100000000000C00010100C0101010101010C1
1111111111111110C00111111111110101010101C0001111100C011111111100C1
100000000000000000010101010101000000000C000101010100C01010101000C1
1000000000000000C001111111111111110101C00011111111100C0111110000C1
10000011111000000001010101010100000C0C0001010101010100C010100C00C1
1000001111100000C0011111111111111111C000111111111111100C0100C0C0C1
1000000C0C0C0C0C0000000000000000000C00000000000000000000C0C0000CC1
1000000000000000000000000000000000E0000000000000000000000C000000C1
111111111111111111111111111111111111111111111111111111111111111111