111111111111111111111111111111111111111111111111111111111111111111
100000000000000000000000000000000000000000000000000000000000000001
10C00000000000000000000000C000000000000000000000000000000000000001
100000000000000000000000000000000000000000000001111111111000000001
10000C000000000000000000000000000000000000000000000000000000000001
100000000000000000000000000000000000000000000000000000000000000001
100000000000000000000000000000000000000000000000000000000000000001
100000000000000000000000000001111111111000000000000000000000000001
100000000C00000000000000000000000000000000000000000000000000000001
100000000000000000000000000000000000000000000000000000000000000001
100000000000000000011111111110000000000000000000000000000000000001
100000000000000000000000000000000000000000000000000000000000000001
1000000000000000000C0000000000000000000000001111111111000000000001
100000000000000000000000000000000000000000000000000000000000000001
100000000000000000000000000000000000000000000000000000000000000001
10000000111111111100000000000C000000000000000000000000000000000001
10000000000000000000000000000000000000000000000000000000000000P001
1000000C00000000000000000000000E0000000000000000000000000000000001
100000000000000000000000000000000000000000000000000000000000000001
100000000000000000000000000000000000000000000000000000000000000001
10000000111111111100000000000C000000000000000000000000000000010001
100000000000000000000000000000000000000000000000000000001000000001
1000000C0000000000000000000000000000000000000000000000000000000001
100000000000000000000000000000000000000000000000000000000000000001
111111111111111111111111111111111111111111111111111111111111111111