111111111111111111111111111111111111111111111111111111111111111111
100000001111111111111111000000000000000000000001000011110000000001
10000000000011111111110000000C00000000C000000001110000000000000001
100000000000000000000000000000000000000000000001111111111000000001
100010010001111100000000000000000000000000000000000000000000000001
100010010000000010001111111111111111000000000000000000000000000001
100011110000000010000000000000000000000000000000000010000000000001
100000010000111100000000000001111111111000000000000010000000000001
100000010C01000000000000000000000000000000000011111111111110000001
100000010001000000000000000000000000000000000000000010000000000001
100000010000111110000000111111111100000000000000000010000000000001
100000000000000000000000000000000000000000000000000000000000000001
1000000000000000000C0000000000000000000000001111111111000000000001
100000000000000000011111111110000000000000111111111100001111111111
100000000000000000000000000000000000000000000000000000000000000001
10000000111111111100000000000C000000000000000000000000000000011101
10000000000000000000000000000000000000000000000000000000000001C101
1000000C0111111111111111111110E1111111111011111111C000000000000001
100000000000000000000000000000P00000000000000000000000000000000001
100000000000000000000000000000000000000000000000000000000000000001
10000000111111111100000000000C000000000000000000000000000000010001
100000000000000000000000000000010000000000000000000000001000000001
1000000C0000000000000000000011111111111111110000000000000000000001
100000000000000000000000000000000000000000000000000000000000000001
100000000000000000011111111111111110000000000001000000001000000001
1000000C0000000000000000000000000000000000000000000000000000000001
100000000000000000011111111111111110000000000001000000001000000001
1000000C000000000000000000000000000000000000000000C000000000000001
1000000C0000000000000000000011111111111111110000000000000000000001
100000000000000000000000000000000000000000000000000000000000000001
100000000000000000011111111111111110000000000001000000001000000001
1000000C0000000000000000000000000000000000000000000000000000000001
100000000000000000011111111111111110000000000001000000001000000001
111111111111111111111111111111111111111111111111111111111111111111