1111111111111
1C0100C000011
1001000011001
1P00C1E0000C1
1111111111111