1111111111111
1C0100C000001
1000000011001
1P0011E0000C1
1111111111111