111111111111111111111111111
1C000000000000C0000000000E1
100011111111100011111111101
1P001000000C000C00000000101
111101111100011110001111101
1C000000000000C0000000000C1
111111111111111111111111111