111111111111111111111111111111111111
11000000C000000C000000C0000000000011
111100011111111001111111100011111101
1C001000C000000000000000001000100001
1000CC111001111C111001111C1111111001
1000P0001000000000C0000E0000000000C1
111111111111111111111111111111111111