1111111111111111111111111111111
1C000000C00000000000000000000E1
10001111110001111111110011100C1
10001000010001000000010000100C1
1P00100010001000000010000100CC1
10001111110001111111110011100C1
1C000000C00000000000000000000C1
1111111111111111111111111111111