111111111111111111111111111111111
1C000001000000C000000C00000100011
100001001000E00001000000001001001
11000C00000011100100011100C0010C1
100001001000000001000000P01001001
1C000001000000C000000C00000100001
111111111111111111111111111111111