1111111111111111111111111111111111111111111111
1CCCC00000000CCCCCC00000000CCCCCC0C00000000011
11CCC11CCC11CCC11CCC11CCC1CCC10CCC0111CCC10001
1C0CCC0CCCCCCCC000CCC000CCCCCC00CCC10000CCC001
10001CCC1CCC1111111CCCP0CCC01CCC1CCC001111CCC1
1C0CCC0CCCCCCCC000CCC000CCCCCC00CCC10000CCC001
10001CCC1CCC1111111CCC10CCC01CCC1CCC001111CCC1
1C0CCC0CCCCCCCC000CCC000CCCCCC00CCC10000CCC001
10001CCC1CCC1111111CCC10CCC01CCC1CCC001111CCC1
1E0000CCCCCC00000001CCCCCC000C0000CCC0000000C1
1111111111111111111111111111111111111111111111